#####
##B##
## ##
#  ##
#A###